139,710,1399,2089,845,1086,1622,2243
703,144,721,1407,1095,836,1097,1630
1399,708,143,711,1636,1089,846,1093
2081,1386,696,138,2250,1615,1090,849
841,1092,1624,2246,136,710,1394,2082
1094,848,1096,1629,715,147,712,1394
1626,1091,838,1091,1405,709,144,703
2249,1624,1088,841,2097,1395,711,131
